NO  1.xpm
SO  2.xpm
WE  3.xpm
EA  4.xpm

C 51,198,150
F 255,255,255


11111
1111111111111111111111111111111111111111111
1000000000000000000000000000000000000000001
1000000000000000000000000000000000000000001
1000000000000000000000000000000000000000001
10000000000000E0000000000000000000000000001
1111111111110000000000111111111111111111111
10110000011100000000000010001   11111111111
10000000001100000111011110001
111101101111110111000000100011111111111111111
111101101111110111010100100000000000000000011
100000000000000000000000000011111011111110011
11111110011111011111111111111   101   1111111
11000000110101011100000010001   101
10000000000000001100000010001   111
10000000000000001100010000001
11000000110101000000010000001
11110111110101000000100000001
10000000011000001000000100001
10000000000000000000000001001
10000001001000010000000001001
10000000001101000010000000001
11111111111100111111111111111
        1111001111
        1011001101
         11100111
          11011
           1001
            11