NO  1.xpm
SO  2.xpm
WE  3.xpm
EA  4.xpm

C 51,198,150
F 255,255,255


11111
11111111111111111111111111111
10000000001100000000000000001
10110000011100000000000010001         
10010000000000000000000010001     
10110000011100000000000010001 
10000000001100000111011110001
111101101111110111000000100011111111111111111
111101101111110111010100100000000000000000011
111111101111111111111111111111111111111110011
11111110111111111111111111111         1111111
11000000110101011100000010001
10000000000000001100000010001
10000000000000001100010000001
11000000110101000000000000001
11110111110101000000000000001
10000000001100000100000010001
10000000000000000000000001001
1000000N001000010000000001001
10000000001101000010000000001
11111111111111111111111111111