NO  2.xpm
SO  1.xpm
WE  3.xpm
EA  4.xpm

C 51,198,150
F 255,255,255


1111
10N01
11111111111111111111111111111