SO 2.xpm
NO 1.xpm
EA 3.xpm
WE 4.xpm

C 137,250,240
F 30,30,30

111111111111
100000000001
100000000001
10000W000001
100000000001
100000000001
111111111111