NO 1.xpm
SO 2.xpm
WE 3.xpm
EA 4.xpm

F 12,12,12
C 255,0,33

11111111111111
10000000000001
10000000000001
100000N0000001
10000000000001
11111111111111